F 76,76,76
C 99,99,99

NO textures/simonkraft/cobblestone.xpm
SO textures/simonkraft/cobblestone_01.xpm
WE textures/simonkraft/mossy_cobblestone1.xpm
EA textures/simonkraft/cobblestone_02.xpm

1111111111111111111
10W1001001001000001
1D11000001000001001
10010010011111D1111
1001111000001001001
100D000000000001001
1001111111111D11001
1111000000000001011
1000000001000000001
1111111111111111111

