F 76,76,76
C 99,99,99

NO textures/wolfenstein/wood.xpm
SO textures/wolfenstein/red_brick.xpm
WE textures/wolfenstein/purple_stone.xpm
EA textures/wolfenstein/color_stone.xpm

11111111111111
10000000000001
11111000000011
10100011111001
10101010000001
10101010N00001
10001010001001
11111011111001
11000000000001
11111111111111
