F 76,76,76
C 99,99,99

NO textures/wolfenstein/wood.xpm
SO textures/wolfenstein/red_brick.xpm
WE textures/wolfenstein/purple_stone.xpm
EA textures/wolfenstein/color_stone.xpm

11111111111111
10000000000001
10001111110001
10100000000101
10100000000101
1010000N000101
10100000000101
10111111111101
10000000000001
11111111111111
