F 76,76,76
C 99,99,99

NO textures/wolfenstein/purple_stone.xpm
SO textures/wolfenstein/red_brick.xpm
WE textures/wolfenstein/wood.xpm
EA textures/wolfenstein/color_stone.xpm

111111111111111111111
101000001000000000001
101010101011111110001
100010100010000010001
111110101111101011101
100000101000101000001
101111101011101111111
101000001010100000101
101010111010111110101
101010001010100010101
101110101010101010101
100000101010001010001
111111101011111011101
100000001000100010001
101110101110101110111
101000100000100010101
101010111111111010101
100010000000000010001
101010111011111111101
1N1000001000000000001
111111111111111111111
